NO ./texture/marbface_64_64.xpm
SO ./texture/marbface_2_64_64.xpm
WE ./texture/marbface_3_64_64.xpm
EA ./texture/mur_lamp_64_64.xpm

F 109,7,26
C 203,10,45

on peut mettre ce a qu on veut ici 

1111111111111111111111111111111111111111111111111111111111111
1000000000000000000000000000000000000000000000000000000000001
10000000000000000000111111111110000000000000000000000000000001
10000000000000000011111111111111000000000000000000000000000001
10000000000000000000000000000000000000000000000000000000000001
10000000000000000000000000000000000000000000000000000000000001
10000000000000000000000000000000000000000000000000000000000001
10000000000000000000000000000000000000000000000000000000000001
10000000000000000000000000000000000011111110000000000000000001
10000000000000000000000000000000000011111110000000000000000001
100000000000000000000000000000000000111111100000000000000000001
100000000000000000000000000000000000000000000000000000000000001
100000000000000000000000000000000000000000000000000000000000001
100000000001111000000000000000000000000000000000000000000000111
100000000000000000000000000000000000000000000000000000000000001
100000000000000000000000000000000000000000000000000000000000001
1000000000000000000000000N0000000000000000000000000000000000001
111111111111111111111111111111111111111111111111111111111111111